#############
# W a l l   #
### ##### ###
# M a r i a #
#############